#####################
#           # #     #
##### ##### # # ### #
#   # #   #   #   # #
# # # # # ####### # #
# #   # #       # # #
# ### # ####### # # #
# #   #      X#   # #
# # ############### #
# # #           # # #
# # # ##### ### # # #
# # # # #   #O#   # #
# ### # # ### # ### #
#       # #     #   #
# ####### # ##### ###
#     #   #   #   # #
##### # ### ### ### #
#   # #   # #   #   #
# ### ### ### ### # #
#       #         # #
#####################
