###########
#         #
# ##### ###
# #   #   #
# # # ### #
# # #     #
# # ##### #
# # #   # #
# # # # # #
# # # #   #
#O#X#######
