###############################
#         #   #               #
# ##### # # # # ######### ### #
# #     # # # #   #     # #   #
# # ##### # ##### ### ### # ###
O # #   # #     #   #   # #   #
### # # # ### ##### ### # #####
#   # #       #   #   # #     #
# ############# # ### # ##### #
# #     #   #   # #   # #     #
# # ### # # # ### # ### # #####
#   #   # #   #   #     #     #
# ### ### ##### ##### ##### # #
#   #   #   # #       #   # # #
### ### ### # ######### # # # #
#   # #   # #         # # # # #
# ### # ### # ####### # # ### #
#     #     #     #   # # #   #
##### ########### # ### # # ###
#   #   # #       #   # #   # #
# # ### # # # ######### ##### #
# #   # # # #       #   #     #
# # # # # # ####### # ### # # #
# # # # # #   #   # # #   # # #
# # # # # ### # # # # ### # # #
# # # # #   # # #   #   # # # X
### ### # ### # ### ####### ###
#   #   #     # # # #     #   #
# ### ######### # # # ### ### #
#               #     #       #
###############################
