###############
#       #     #
# # ### # ### #
# #   # #   # #
# ### ### ### #
# # #   # #   #
# # ### # # ###
# # #   # #X# #
# # # ### ### #
# # #     #   #
# # ####### # #
#     #O    # #
##### ####### #
#             #
###############
