###############
X #           #
# # ##### ### #
# #   # # #   #
# ### # # ### #
#   # # #   # #
# ### # ### ###
# #       #   #
# # ######### #
# # #   #     #
# # # # # ### #
#   # #   #   #
# ### ####### #
#   #       # #
#############O#
