#########################################
#         #   #           #     #       #
####### # # # ### ####### ### # # ### # #
#       #   #     #     #   # #     # # #
# ################# ### ### ######### # #
#     # #       # # # # #   #         # #
# ### # # ### # # # # # # ### # ####### #
# #   # # # # #   # # #       # #     # #
### ### # # # ##### # ########### ### # #
#   #       # #   # # #   #     #   # # O
# ########### # # # # # # # ### ### # ###
#     #       # # # #   # # # #     #   #
# ### # ### ### # # # ### # # ######### #
# # # #   # #   #   # #   #   #     #   #
# # # ### # # ######### # ### # ### # ###
#   #   # # # #   #     #   # # #   #   #
### ### # ### # # # ####### # # # # ### #
#     # #   #   # #   #   # # # # # # # #
# ##### # # ##### ### # # # # # # # # # #
# #     # #     #   # # #   # # # #   # #
### ##### ##### ### # # ##### ### ##### #
#   #   #     #   # # #   #   #   #     #
# ### # ### ##### # # ### # ### ### ### #
#     #   # #   #   # #   #   #   #   # #
# ####### # # # # ### ####### ### ### # #
#       # # # # #   # #       #     # # #
####### # ### # ### # # ####### ### # ###
#     # # #   #   # # #     #   # # #   #
# # ### # # ##### # # ##### ### # # ### #
# # #   # #   #   #   #   #     #     # #
# # # ### ### # ### ### # ### ####### # #
# #   # #     #   # #   #     #     # # #
# ##### ######### ### ######### ### # # #
#   #         #   #       #   # # # # # #
### # ######### # # ####### # # # # # # #
X # #   #       # # #       # # # # # # #
# # ### # ######### # ####### # # # # # #
# # #   # #     #   # # #     # #   # # #
# # # # # # ### # ### # # ##### # ##### #
#     # #     #   #   #         #       #
#########################################
