#########O#
#   #   # #
# ##### # #
#     #   #
# # # ### #
# # # #   #
# # ### ###
# # #   # #
# # # ### #
# #       #
#X#########
