#####################
O   #     #         #
# # # ### # ### #####
# #   # #     #     #
# ##### ####### ### #
# #       #   #   # #
# # # ##### # ##### #
# # # #   # #       #
# # ### # # ####### #
# #   # #   #       #
# # # # ######### ###
# # # #   #     #   #
# ### ### # ### ### #
# #   #   # #X  #   #
# # # # ### ##### ###
#   # #   # #   #   #
##### ### # ### ### #
# #   # # # #     # #
# # ### # # # ##### #
#       #   #       #
#####################
