###########
#         #
# ####### #
#       # #
######### #
#  X#   # #
# ### # # #
#     # # #
####### # #
O         #
###########
