###########
#         #
# ####### #
#   #     #
# # # #####
# # #     #
# # ##### #
# # #   # #
# # # ### #
# #   #X  #
#O#########
