###############
X             #
# # ######### #
#   #     # # #
# ### ### # # #
#     #   #   #
####### ### ###
#     #   #   #
# ### # # ### #
# #     #     #
# ######### # #
# #   #   # # #
# # # # # ### #
#   #   #     O
###############
