###############################
#       #       #             #
##### # # ##### # # ######### #
#     #   #     # # #         #
# # ####### ### # # # ####### #
#   #         #   # #     #   #
# ### ####### ### # ##### # ###
#     #   #     # # #   # #   #
# ##### # # ### # # # # # # # #
#       # #         # # # # # #
######### # ##### # # # # # # #
#   #     #     #   # # #   # #
# ### ######### ##### # ##### #
#   # #       #     # # #     #
# # # # ### # ##### # # # ### #
X #   # #   #   # #   # # #   O
# ##### # ##### # ##### # # ###
#   #   #     # #     # # #   #
### # ####### # # # ### # ### #
#   #       # # # # #   #     #
# ### ##### # # # # # ####### #
#     #   #   # #   #   #     #
####### # ##### ### ### # #####
#   #   #     # #     # #   # #
# ### # ##### # # ### # ### # #
#   # #   #   #   # # #   # # #
# # # ### # ####### # ### # # #
# #   # # #   #       #   #   #
# ##### # ##### ####### ##### #
#       #             #       #
###############################
