###############################
#    X#             #         #
# # ### ### # ##### # ####### #
#   #     # # #   # #     #   #
# ### # ### # # # # ##### # ###
#   # # #   #   #   #     # # #
# # # # # ##### ##### ##### # #
# #   # # #   # #   #     # # #
# ##### # # # # # # ##### # # #
#   #   # # # # # #       #   #
### # # # # # # # ########### #
#     # #   # #   #         # #
# ##### ##### ##### ####### # #
#   #       # #   #       #   #
### # ##### # # # ####### #####
#   #     # # # # #   #   #   #
# ##### # # # # # # # # ### ###
# #   # # # # # # # # #       #
### # ### # # # # # # # ### # #
#   #     #     #   #     # # #
# ####################### ### #
#     #         #       #     #
##### # ####### # ##### ##### #
#     # #   # #         #     #
# ##### # # # ######### # #####
#         #     #   #   # #   #
################# # # ### # # #
#            O#   #   #   #   #
# ############# ####### ##### #
#                             #
###############################
