#########O###########
#         #         #
# # ##### # # ### # #
# #   #   # # #   # #
# ### # ### # # #####
#   # #       #     #
# ### ############# #
#   #       #       #
# # # ##### # # #####
# #   #   # # # #   #
# ##### # # # ### # #
#       #     #   # #
# ######### ### ### #
# #   #     #   #   #
# # # # ##### ### # #
#   #   #     #   # #
# ##### # ##### ### #
# #   # # #   #   # #
# ### # # # # ### # #
#     #   # #     # #
#########X###########
