###############
O   #   #     #
# # # # # ### #
# #   # #     #
# ####### ### #
#   #   # #   #
### ### # # ###
#     #   #   #
# ### ####### #
#   # #   #   #
# # # # # # # #
# #   # # # # #
# ##### # # # #
#       #   # X
###############
