###########
#         #
# ##### ###
# #   #   #
# # # # # #
# # # #   #
# # # ### #
O # # #   #
### # # # #
X   #     #
###########
