#########O#
#       # #
# ##### # #
#     # # #
##### # # #
#   # #   #
# # # #####
#     #   #
# ##### # #
#       # #
#########X#
