#######################################X#
#     #                               # #
# ### # # ######### ##### ####### ### # #
# #   # #   #     # #   #       # # #   #
# # # # ### # # # # # # ####### # # ### #
# # # #   # # # # # # #     #   # #     #
# # # ### # # # ### # ##### # # # # #####
#   # #   # # #   #       # #   # #   # #
# ### # ### # # # ######### ##### ### # #
#   # #   #   # #     #   #     # #   # #
# # ### # # ### # ### # ####### # # # # #
#     # # # #   # #   #       # # #     #
##### # # # ### # # ######### # # ##### #
#     # # # #   #       #     # #     # #
# ##### # # # ######### # ##### # ### ###
#       #   #   #       #       #   #   #
# ####### ### # # ##### ########### ### #
#       # #   # #   #             #     #
# ##### # ##### ### ############# # #####
# #     #     #   #               #     #
# # ######### # # ####### ### ##### ### #
# #   #     # # #   #   #   #     #   # #
# ### # # ### # ### # # ### ##### ##### #
#   # # #   # # # #   # #               #
# # # # ### # # # ##### # ############# #
# #   #  O# # # #   #   #       #       #
# ### ##### # # ### # ######### # #######
#   # #     # #   # #     #     # #     #
### # # ##### ### # # # ### ##### # ### #
#   # #   #   #       # #   #   #       #
# # # ### # ### ### ### # ### # ####### #
# # # #   # #     # #   # #   #   #   # #
# # # # ### ### # # # ### # ##### # ### #
# # # #         # # # #   # #   # #     #
# # # ##### ##### # # # # # ### # # #####
# #       #     #     # #       # # #   #
# ####### ##### # ##### ### ##### # # # #
# #       #   #   #   #     #     # # # #
# # ####### # ##### # ####### ##### ### #
#           #       #         #         #
#########################################
