###########O#############################
#         #   #           #         #   #
# # ### # ### # # ### ### # ### ### # # #
#     # #   #     #   # #     #   # # # #
# ### # ### ####### # # # ### ### # # ###
#   #   # #     #   #     #   #   # #   #
### # ### ##### # ##### ### ### # # # # #
#   #         # #   #   #       #   # # #
# ### ### ### # ### # # # ######### # # #
#   #   # #   #   # # # # #   #   #     #
### ### # # ##### # # ### # # # # ##### #
#   #   #         # # #   # #   # #   # #
# ### # ####### ### # # ### ##### ### # #
# #   #   #   #     #     # #     #   # #
# # # ### # # ### ######### # # ### ### #
#   # # #   # #   #         # #   #     #
##### # ##### # ####### ##### ### #######
#   #   #   # #         #       # #     #
# ##### # # # # ##### ### ##### # # ### #
# #     # # # #     #   # #   #   #   # #
# # ##### # # # ####### # # # ##### # # #
#         # # # #       #   # #     #   #
########### # # # ##### ##### ### ### ###
#     #     #   #   #   #   #   # # #   #
# ### ##### # ##### # # ### ### # # ### #
#   #     # #   #   # #       # # #   # #
# # ##### # ### # ### ####### # # # # # #
# # #     #     # #           #   # #   #
# # # ####### ### # ####### ####### #####
# # #       # #   #       # #     #   # #
# # ####### ### # # ##### # # ### # # # #
# # #   #       # #     # #   #   # #   #
# # # # ######### ##### # ##### ### ### #
# #   # #   #         # #   #         # #
# ##### # # # ####### # ### ##### ##### #
# #   #   # #   #   #     #     #       #
# # # ##### ##### # ##### ##### ### #####
# #     # # #     #   #   #   #   # #X  #
# ### # # # # ####### # ##### # # # ### #
#     #   #                     #       #
#########################################
