#####################
#                   #
# ### ############# #
#  O#           #   #
########### ### # ###
#         #     #   #
# ####### ### ### # #
#     # #     # # # #
##### # ##### # # # #
#     #       #   # #
# ##### ########### #
#     #     #       #
##### ##### # #######
#     #     #       #
# # # # # ######### #
# #   # #   #       #
# ### # ### # #######
#     # #   #   #X  #
# # ### # ##### ### #
# #     #           #
#####################
